16 12 3
00 01 02 00 01 02 00 01 02 00 01 02 00 01 02 00 13 
01 02 00 01 02 00 01 02 00 01 02 00 01 02 00 01 13 
02 00 07 07 07 07 07 07 07 07 07 07 07 07 01 02 13 
00 01 07 07 07 07 07 07 07 07 07 07 07 07 02 00 13 
01 02 07 07 07 07 07 07 07 07 07 07 07 07 00 01 13 
02 00 07 07 00 01 02 00 01 02 00 07 07 07 01 02 13 
00 01 07 07 01 07 07 01 02 00 01 07 07 07 02 00 13 
01 02 07 07 02 07 07 02 00 01 02 07 07 07 00 01 13 
02 00 07 07 00 01 02 00 01 02 00 07 07 07 01 02 13 
00 01 07 07 07 07 07 05 02 00 01 09 07 07 02 00 13 
01 02 00 01 02 00 01 00 00 01 02 00 01 02 00 01 13 
02 00 01 02 00 01 02 00 01 02 00 01 02 00 01 02 14 
300 125 0
111 600 0
700 300 2