20 15
00 01 02 00 07 07 00 01 07 07 00 07 07 00 01 02 00 01 02 00 13
01 02 00 01 07 07 01 02 07 07 01 07 07 01 02 00 01 02 00 01 13
00 01 02 00 01 02 00 01 07 07 02 07 07 00 01 02 00 01 02 00 13
01 02 00 01 02 00 01 02 07 07 01 07 07 01 02 00 01 02 00 01 13
00 01 02 00 07 07 00 01 07 07 00 07 07 00 01 02 00 01 02 00 13
01 02 00 01 07 07 01 02 07 07 01 07 07 01 02 00 01 02 00 01 13
00 01 02 00 07 07 00 01 07 07 02 07 07 00 01 02 00 01 02 00 13
01 02 00 01 07 07 01 02 07 07 01 07 07 01 02 00 01 02 00 01 13
00 01 02 00 07 07 00 01 07 07 00 01 02 00 01 02 00 01 02 00 13
01 02 00 01 07 07 01 02 07 07 01 02 00 01 02 00 01 02 00 01 13
00 01 02 00 07 07 00 01 07 07 02 07 07 00 01 02 00 01 02 00 13
01 02 00 01 07 07 01 02 00 01 01 07 07 01 02 00 01 02 00 01 13
00 01 02 00 07 07 00 01 07 07 00 07 07 00 01 02 00 01 02 00 13
01 02 00 01 07 07 01 02 07 07 02 07 07 01 02 00 01 02 00 01 13
00 01 02 00 07 07 00 01 07 07 01 07 07 00 01 02 00 01 02 00 14