32 25 8
4 9 4 9 4 9 4 9 4 9 4 9 4 9 4 9 4 4 4 4 4 4 4 4 4 4 4 4 4 4 4 4 
9 4 9 4 9 4 9 4 9 4 9 4 9 4 9 4 9 9 9 9 9 9 9 9 9 9 9 9 9 9 9 4 
4 9 4 9 4 9 4 9 4 9 4 9 4 9 4 9 4 4 4 4 4 4 4 4 4 4 4 4 4 4 9 4 
9 4 9 4 9 4 9 4 9 4 9 4 9 4 9 4 9 9 9 9 9 9 9 9 9 9 9 9 9 4 9 4 
4 9 4 9 4 9 4 9 4 9 4 9 4 9 4 9 4 4 4 4 4 4 4 4 4 4 4 4 9 4 9 4 
9 4 9 4 9 4 9 4 9 4 9 4 9 4 9 4 9 9 9 9 9 9 9 9 9 9 9 4 9 4 9 4 
4 9 4 9 4 9 4 9 4 9 4 9 4 9 4 9 4 4 4 4 4 4 4 4 4 4 9 4 9 4 9 4 
9 4 9 4 9 4 9 4 9 4 9 4 9 4 9 4 9 9 9 9 9 9 9 9 9 4 9 4 9 4 9 4 
4 9 4 9 4 9 4 9 4 9 4 9 4 9 4 9 4 4 4 4 4 4 4 4 9 4 9 4 9 4 9 4 
9 4 9 4 9 4 9 4 9 4 9 4 9 4 9 4 9 9 9 9 9 9 9 4 9 4 9 4 9 4 9 4 
4 9 4 9 4 9 4 9 4 9 4 9 4 9 4 9 4 4 4 4 4 4 9 4 9 4 9 4 9 4 9 4 
9 4 9 4 9 4 9 4 9 4 9 4 9 4 9 4 9 9 9 9 9 4 9 4 9 4 9 4 9 4 9 4 
4 9 4 9 4 9 4 9 4 9 4 9 4 9 4 9 4 4 4 4 9 4 9 4 9 4 9 4 9 4 9 4 
9 4 9 4 9 4 9 4 9 4 9 4 9 4 9 4 9 9 9 9 9 4 9 4 9 4 9 4 9 4 9 4 
4 9 4 9 4 9 4 9 4 9 4 9 4 9 4 9 4 4 4 4 4 4 9 4 9 4 9 4 9 4 9 4 
4 9 4 9 4 9 4 9 4 9 9 9 9 9 9 9 9 9 9 9 9 9 9 4 9 4 9 4 9 4 9 4 
4 9 4 9 4 9 4 9 4 4 4 4 4 4 4 4 4 4 4 4 4 4 4 4 9 4 9 4 9 4 9 4 
4 9 4 9 4 9 4 9 9 9 9 9 9 9 9 9 9 9 9 9 9 9 9 9 9 4 9 4 9 4 9 4 
4 9 4 9 4 9 4 4 4 4 4 4 4 4 4 4 4 4 4 4 4 4 4 4 4 4 9 4 9 4 9 4 
4 9 4 9 4 9 9 9 9 9 9 9 9 9 9 9 9 9 9 9 9 9 9 9 9 9 9 4 9 4 9 4 
4 9 4 9 4 4 4 4 4 4 4 4 4 4 4 4 4 4 4 4 4 4 4 4 4 4 4 4 9 4 9 4 
4 9 4 9 9 9 9 9 9 9 9 9 9 9 9 9 9 9 9 9 9 9 9 9 9 9 9 9 9 4 9 4 
4 9 4 4 4 4 4 4 4 4 4 4 4 4 4 4 4 4 4 4 4 4 4 4 4 4 4 4 4 4 9 4 
4 9 9 9 9 9 9 9 9 9 9 9 9 9 9 9 9 9 9 9 9 9 9 9 9 9 9 9 9 9 9 4 
4 4 4 4 4 4 4 4 4 4 4 4 4 4 4 4 4 4 4 4 4 4 4 4 4 4 4 4 4 4 4 4 
16 160 4
96 144 4
144 144 4
240 160 4
400 256 4
464 480 4
608 560 4
816 336 4
