15 15 0
4 4 4 4 4 4 4 4 4 4 4 4 4 4 4
4 4 4 4 4 4 4 4 4 4 4 4 4 4 4
4 4 13 13 13 13 13 13 13 13 13 13 13 4 4
4 4 13 4 4 4 4 4 4 4 4 4 13 4 4
4 4 13 4 13 13 13 13 13 13 13 4 13 4 4
4 4 13 4 13 10 10 10 10 10 13 4 13 4 4
4 4 13 4 13 10 13 13 13 10 13 4 4 4 4
4 4 13 10 10 10 13 10 10 10 13 4 4 4 4
4 10 13 10 13 4 13 13 13 4 13 10 10 10 4
4 10 13 10 13 4 4 4 4 4 13 10 13 10 4
4 10 13 10 13 13 13 13 13 13 13 10 13 10 4
4 10 13 10 10 10 10 10 10 10 10 10 13 10 4
4 10 13 13 13 13 13 13 13 13 13 13 13 10 4
4 10 10 10 10 10 10 10 10 10 10 10 10 10 4
4 4 4 4 4 4 4 4 4 4 4 4 4 4 4
